######                                                                                                                                                               #
#                                                            461                      452  410  336  359                                                        #
#                                                             |                        |    |    |    |                                                         #
#                                                             |                        |    |    |    |                                                         #
#                                                            457       436  481       347--291--286  319--345                                                   #
#                                                             |         |    |         |         |    |    |                                                    #
#                                                             |         |    |         |         |    |    |                                                    #
#                                             470  459--458  426  441  350--404  353  442  337  285  269  375--385                                              #
#                                              |         |    |    |    |         |         |    |    |                                                         #
#                                              |         |    |    |    |         |         |    |    |                                                         #
#                                   469--425  454--423--408  422  372  332  374--325  296  271--267  227  288  424--473--494                                    #
#                                         |              |    |    |    |         |    |         |    |    |    |                                               #
#                                         |              |    |    |    |         |    |         |    |    |    |                                               #
#                                        418--415--406  361  302  363--328--357  280--248--231  172  200--206--380  392--462                                    #
#                                         |         |    |    |         |                   |    |    |              |                                          #
#                                         |         |    |    |         |                   |    |    |              |                                          #
#                                        474  447  405--303--284  368  312--268--411  290--207--151--147--153--329  344--390                                    #
#                                              |              |    |         |                        |              |                                          #
#                                              |              |    |         |                        |              |                                          #
#                                        450--445--339--287  252--234  219  203--299--311  210  132  134--144--155--316  331--446--466--472                     #
#                                                        |         |    |    |              |    |    |         |         |         |                           #
#                                                        |         |    |    |              |    |    |         |         |         |                           #
#                                        499--456--275--242--218--216--204--165  208--182--157  116  119  152  187  201  283--313  486                          #
#                                                        |    |              |              |    |    |    |         |    |                                     #
#                                                        |    |              |              |    |    |    |         |    |                                     #
#                                             412--310--259  263  245--237--125--083--130  124  115--095  094  160  192--223                                    #
#                                              |                   |              |         |         |    |    |    |                                          #
#                                              |                   |              |         |         |    |    |    |                                          #
#                                             488  348  246  314--254  191  110--076--072  122--088--053  069--103  174--224                                    #
#                                                   |    |              |              |              |    |         |                                          #
#                                                   |    |              |              |              |    |         |                                          #
#                                             429  320  215  190  180  082--064  073--063  040  041--039--051--057--145--220                                    #
#                                              |    |    |    |    |         |         |    |         |                                                         #
#                                              |    |    |    |    |         |         |    |         |                                                         #
#                                        448--364--257--146--099--091--084--062--046--020--027--030--032--054  169--186--205--479                               #
#                                              |         |         |                   |    |    |              |         |                                     #
#                                              |         |         |                   |    |    |              |         |                                     #
#                                        394--381  346--177  113--101  087  071  077--019  028  031--033--038--066--123  241--266  279  416                     #
#                                                             |         |    |         |                   |                        |    |                      #
#                                                             |         |    |         |                   |                        |    |                      #
#                                        453--451--402--176--114  161--074  047--043--010  023--026--055  059--092  128--189--255  265--270--338  476--440      #
#                                         |                             |              |    |              |         |              |         |         |       #
#                                         |                             |              |    |              |         |              |         |         |       #
#                                        464  400  366--335--188--139--065--058  001--000--004--013--015  104--107--121--143--212  249--282  379--395--421      #
#                                              |                             |         |                        |                   |              |            #
#                                              |                             |         |                        |                   |              |            #
#                                        376--369  295  365  304  162--067--016--008  002--003--005  024  044  120--127--184--221--240--386--414  403           #
#                                              |    |    |    |                   |    |    |         |    |                   |                                #
#                                              |    |    |    |                   |    |    |         |    |                   |                                #
#                                   495--383--330  272  305  301  171--061--056--007--006  009--011--017--042--118--137  209  253--258--306--397  443--471      #
#                                              |    |    |    |                             |              |              |                        |            #
#                                              |    |    |    |                             |              |              |                        |            #
#                                        355--235--232  222  292--148--136--049--029--021--012--014--037  080--086--090--178--243--256--327--427--430--439      #
#                                                   |    |                   |    |         |    |         |    |              |    |                           #
#                                                   |    |                   |    |         |    |         |    |              |    |                           #
#                                        419--276--197--196--159--142--102  079  045  025--018  034--035  081  096--097--181  293  360--398--438--465--498      #
#                                                                       |         |         |    |    |                                                         #
#                                                                       |         |         |    |    |                                                         #
#                                   497--437--420--213--179--175--109--098--070--060--036--022  050  052--075--085--154--193--251--315  382--388--477--483      #
#                                              |         |    |    |    |    |         |    |    |    |                                  |                      #
#                                              |         |    |    |    |    |         |    |    |    |                                  |                      #
#                                   493--490--444  238--233  183  185  126  163  149--048  078  089  068--100--112--140  217--247--261--322--435                #
#                                                             |         |              |    |    |         |    |         |         |                           #
#                                                             |         |              |    |    |         |    |         |         |                           #
#                                        478--351--343  236--229  170--129--194  202--105  108--093  135--106  141--156--164--298  277--323--433--460           #
#                                              |    |    |    |              |              |         |    |         |         |              |                 #
#                                              |    |    |    |              |              |         |    |         |         |              |                 #
#                                             491  273--264  250--289  226--214--173--133--117--166--150  111--158  168--340  324--354       455                #
#                                                        |    |         |                   |    |         |    |              |                                #
#                                                        |    |         |                   |    |         |    |              |                                #
#                                                  308--274  294  389--300  225--195--138--131  198--199  367  167--260  356--349--384                          #
#                                                             |         |    |    |    |    |    |    |         |              |                                #
#                                                             |         |    |    |    |    |    |    |         |              |                                #
#                                                  428--391--334--341  377  278  228  211  244--239  230--297  262--358--401  352--485                          #
#                                                        |    |    |              |                   |         |              |                                #
#                                                        |    |    |              |                   |         |              |                                #
#                                                       396  393  449  409--317--281--309--326  321--307--371  370--407  463--362                               #
#                                                             |              |    |    |    |    |    |    |    |    |    |    |                                #
#                                                             |              |    |    |    |    |    |    |    |    |    |    |                                #
#                                                            482  492--431--387  318  333  342  413  373  475  434  496  468  399                               #
#                                                                            |    |    |    |         |    |                   |                                #
#                                                                            |    |    |    |         |    |                   |                                #
#                                                                           417  487  378  432       480  484                 467                               #
#                                                                                 |                                                                             #
#                                                                                 |                                                                             #
#                                                                                489                                                                            #
#                                                                                                                                                               #
#####